BACKWARD	B AE K W ER D
BEHIND	B IH HH AY N D
CONTINUE	K AH N T IH N Y UW
FASTER	F AE S T ER
FORWARD	F AO R W ER D
HALT	HH AO L T
KILL	K IH L
L	EH L
LEFT	L EH F T
MAX	M AE K S
ONE	W AH N
ONE(2)	HH W AH N
PAUSE	P AO Z
R	AA R
RIGHT	R AY T
ROBOT	R OW B AA T
ROBOT(2)	R OW B AH T
SAM	S AE M
SPEECH	S P IY CH
SPEED	S P IY D
STOP	S T AA P
STRAIGHT	S T R EY T
TWO	T UW
UP	AH P
